11111111111111111
1TC1100C0000C1011
11000C11011010C01
1C010P0C01C000101
11110101110111001
10C001C0E100C1C11
11111111111111111