1111111111
10000111C1
1C110000T1
11C00C1111
10010P0C01
1011010111
10C001C0E1
1111111111