1111111111
1C010000T1
11C00C1101
10010P0C01
1011010111
10C001C0E1
1111111111