11111111111111111
10C110TC000TC1001
10000C11011010C01
1C010P0C01C0T0101
11110101110111001
1T0C01C0E100C1C01
11111111111111111