1111111111
1PC10C0C01
11C00C1101
1001000C01
1011010111
10C001C0E1
1111111111