1111111111
1P010C0C01
10C00C1101
1001000C01
1001010111
10C001C0E1
1111111111