111111111111111111111111111
1E0000000000000C00000C00011
101001010010000010100100011
101001001010101000100100011
1P0000000C00C00000000000011
111111111111111111111111011
111111111111111111111111011
100000000000000C00000C00011
101001010010000010100100011
101001001010101000100100011
111111111111111111111111111