11111111111111111111111111111111
10C10C0C011111111111111111111111
11C00C11011111111111111111111111
10010P0C011111111111111111111111
10110101111111111111111111111111
10C001C0E11111111111111111111111
11111111111111111111111111111111
11111111111111111111111111111111
11111111111111111111111111111111
11111111111111111111111111111111
11111111111111111111111111111111
11111111111111111111111111111111
11111111111111111111111111111111
11111111111111111111111111111111
11111111111111111111111111111111
11111111111111111111111111111111
11111111111111111111111111111111