111111111111111111111111111111111
10C10C0C0111111111111111111111111
11C00C110111111111111111111111111
10010P0C0111111111111111111111111
101101011111111111111111111111111
10C001C0E111111111111111111111111
111111111111111111111111111111111
111111111111111111111111111111111
111111111111111111111111111111111
111111111111111111111111111111111
111111111111111111111111111111111
111111111111111111111111111111111
111111111111111111111111111111111
111111111111111111111111111111111
111111111111111111111111111111111
111111111111111111111111111111111
111111111111111111111111111111111
111111111111111111111111111111111