11111111111111111111111111
10000000000000000C00000001
10010010111100111101111001
10010010000100100101001001
1P010C10C00100100001001001
10011110111100111101111001
10000010100000000101000001
1000001010000010E101000001
10000010111100111101000001
10000000000000000000000001
11111111111111111111111111