1111111111111
1C01000C0C1C1
11C00C1101101
10010P0C00001
1011010111C11
10C001C0010E1
1111111111111