1111111111
10C10C0C01
11C00C1101
10010P0C01
1011010001
10C001C0E1
1011010001
1011010001
1111111111