111111111
1T00C0001
11C111101
1001T0001
101110111
100C1C1C1
101110101
101C00001
1C1111101
100P1E001
111111111